************
*----------*
<----------*
*----------*
*----------*
*----------*
*----------*
*----------*
*----------*
*----------*
*----------*
*****v******