****************************************
*--------------------------------------*
*--------------------------------------*
*--------------------------------------*
*--------------------------------------*
*--------------------------------------*
*--------------------------------------*
*--------------------------------------*
*--------------------------------------*
*--------------------------------------*
<-------------------------------------->
*--------------------------------------*
*--------------------------------------*
*--------------------------------------*
*--------------------------------------*
*--------------------------------------*
*--------------------------------------*
*--------------------------------------*
*--------------------------------------*
********************v*******************