****************************************
*--------------------------------------*
*--------------------------------------*
*--------------------------------------*
*--------------------------------------*
*--------------------------------------*
*--------------------------------------*
*--------------------------------------*
*--------------------------------------*
*--------------------------------------*
<--------------------------------------*
*--------------------------------------*
*--------------------------------------*
*--------------------------------------*
*--------------------------------------*
*--------------------------------------*
*--------------------------------------*
*--------------------------------------*
*--------------------------------------*
********************v*******************