********************ʌ*******************
*--------------------------------------*
*--------------------------------------*
*--------------------------------------*
*--------------------------------------*
*--------------------------------------*
*--------------------------------------*
*--------------------------------------*
*--------------------------------------*
*--------------------------------------*
*-------------------------------------->
*--------------------------------------*
*--------------------------------------*
*--------------------------------------*
*--------------------------------------*
*--------------------------------------*
*--------------------------------------*
*--------------------------------------*
*--------------------------------------*
********************v*******************