************
*P---------*
*----------*
*----------*
*----------*
*---------->
*----------*
*----------*
*----------*
*--------O-*
*----------*
*****v******