************
*A---------*
*-P--------*
*----------*
*----------*
*---------->
*----------*
*----------*
*----------*
*--------O-*
*----------*
*****v******