********^***
*----------*
*----------*
*----------*
*----------*
*----------*
*----------*
*----------*
*----------*
<----------*
*----------*
************